6 15 8
********t******
***t***********
t********t*****
***t**p*****t**
*****t*t*t*t***
***************