7 15 7
***ttttt*******
**t*****t******
**t*******t****
*****p******t**
**t*****tt*****
***ttttt**t*t**
***************