8 10 6
***t******
******t***
**t**t****
**t**p****
******t***
***t******
*****t****
**********